1,1,1,1,1,1,1,1,1,1,1,1,1,1,1
1,0,0,0,0,0,0,0,0,1,1,1,1,1,1
1,0,-1,0,-1,0,-1,0,11,12,11,11,3,1,1
1,4,0,0,0,0,0,0,0,12,1,1,1,1,1
1,0,-2,0,-2,0,-2,0,0,12,0,0,0,0,1
1,0,0,-9,0,0,0,0,0,12,0,1,1,0,1
1,0,-2,0,-2,0,-2,0,0,12,0,0,0,2,1
1,0,0,0,0,0,0,0,1,11,11,11,11,10,1
1,1,1,1,1,1,1,1,1,1,1,1,1,1,1
