1,1,1,1,1,1,1,1,1,1,1,1,1
1,0,0,0,0,0,0,1,1,2,1,0,1
1,0,1,1,1,1,0,1,1,0,1,0,1
1,0,1,1,1,0,-1,1,0,0,1,0,1
1,0,0,-2,0,0,0,0,0,0,0,51,1
1,0,1,1,1,0,1,1,1,40,1,0,1
1,0,1,1,0,0,1,1,1,1,1,0,1
1,-9,1,1,0,0,0,50,0,41,1,3,1
1,1,1,1,1,1,1,1,1,1,1,1,1
