{
	"data": [
		[ 1, 1, 1, 1, 2, 1, 1, 1, 1, 0, 0, 0, 1, 1],
		[ 1, 0, 0, 0, 0, 0, 0, 0, 0, 0, 0, 0, 0, 1],
		[ 1, 0, 0, 0, 0, 0,-1, 0, 0,-2, 0, 0, 0, 1],
		[ 1, 0, 0,-9, 0, 0, 0, 0, 0,-3, 0, 0, 0, 1],
		[ 1, 0, 0, 1, 0, 1, 0,40, 0, 0, 0, 0, 0, 1],
		[ 1, 0, 0, 1, 0, 0, 0, 0, 0, 0,50, 0, 0, 1],
		[ 1, 0, 0, 1, 1, 1, 1, 1, 1, 0, 0, 0, 0, 1],
		[ 1, 0, 0, 0, 0, 0,10,20, 1, 0, 0, 0, 0, 1],
		[ 1, 0, 0, 0, 0, 0, 1, 1, 1, 0, 0, 0, 0, 1],
		[ 1, 1, 1, 1, 1, 1, 1, 1, 1, 0, 0, 0, 1, 1]
	],
	"floor": [
		[99,99,99,99,99,99,99, 1, 1, 1, 1, 1, 1, 1],
		[99,99,99,99,99,99,99,21, 0, 0, 0, 0, 0, 1],
		[99,99,99,99,99,99,99,21, 0, 0, 0, 0, 0, 1],
		[99,99,99,99,99,99,99,21, 0, 0, 0, 0, 0, 1],
		[99,99,99,99,99,99,99,21, 0, 0, 0, 0, 0, 1],
		[99,99,99,99,99,99,99,21, 0, 0, 0, 0, 0, 1],
		[99,99,99,99,99, 1, 1, 1, 0, 0, 0, 0, 0, 1],
		[99,99,99,99,99, 1,21,11, 0, 0, 0, 0, 0, 1],
		[99,99,99,99,99, 1, 1, 1, 0, 0, 0, 0, 0, 1],
		[99,99,99,99,99, 1, 1, 1, 1, 0, 0, 0, 1, 1]
	]
}

