{
	"data": [
		[ 1, 1, 1, 1, 2, 1, 1, 1, 1, 0, 0, 0, 1, 1],
		[ 1, 0, 0, 0, 0, 0, 0, 0, 0, 0, 0, 4, 0, 1],
		[ 1, 0, 0, 0, 0, 0,-1, 0, 0,-2, 0, 4, 0, 1],
		[ 1, 0, 0,-9, 0, 0, 0, 0, 0, 0, 0, 0, 0, 1],
		[ 1, 0, 0, 1, 0, 1, 0,40, 0, 0,50, 0, 0, 1],
		[ 1, 0, 0, 1, 0, 0, 0,41, 0, 0,51, 0, 0, 1],
		[ 1, 0, 0, 1, 1, 1, 1, 1, 1, 0,50, 0, 0, 1],
		[ 1, 0, 0, 0, 0, 0, 0, 0, 1, 0, 0, 0, 0, 1],
		[ 1, 0, 0,10,10,11, 0, 0, 1, 0, 0, 0, 0, 1],
		[ 1, 0, 0,13, 0,11, 0, 0, 1, 0, 0, 0, 0, 1],
		[ 1, 0, 0,13,12,12, 0, 0, 1, 0, 0, 0, 0, 1],
		[ 1, 0, 0, 0, 0, 0, 0, 0, 1, 0, 0, 0, 0, 1],
		[ 1, 1, 1, 1, 1, 1, 1, 1, 1, 0, 0, 0, 1, 1]
	],
	"extraSpawns": [
		{"x":8, "y":3, "id":-4}
	],
	"floor": [
		[99,99,99,99,99,99,99, 1, 1, 1, 1, 1, 1, 1],
		[99,99,99,99,99,99,99,21, 0, 0, 0, 0, 0, 1],
		[99,99,99,99,99,99,99,21, 0, 0, 0, 0, 0, 1],
		[99,99,99,99,99,99,99,21, 0, 0, 0, 0, 0, 1],
		[99,99,99,99,99,99,99,21, 0, 0, 0, 0, 0, 1],
		[99,99,99,99,99,99,99,21, 0, 0, 0, 0, 0, 1],
		[99,99,99,99,99, 1, 1, 1, 0, 0, 0, 0, 0, 1],
		[99,99,99,99,99, 1,21,11, 0, 0, 0, 0, 0, 1],
		[99,99,99,99,99, 1, 1, 1, 0, 0, 0, 0, 0, 1],
		[99,99,99,99,99, 1, 1, 1, 1, 0, 0, 0, 1, 1]
	]
}

