{
	"data": [
		[ 1, 1, 1, 1, 1, 1, 1, 1, 1, 1, 1, 1, 1, 1, 1],
		[ 1, 0, 0, 0, 0, 0, 0, 0, 0, 1, 1, 1, 1, 1, 1],
		[ 1, 0,-1, 0,-1, 0,-1, 0,10,11,10,10, 3, 1, 1],
		[ 1, 0, 0, 0, 0, 0, 0, 0, 0,11, 1, 1, 1, 1, 1],
		[ 1,-4,-2, 0,-2, 0,-2, 0, 0,11, 0, 0, 0, 0, 1],
		[ 1, 0, 0,-9, 0, 0, 0, 0, 0,11, 0, 1, 1, 0, 1],
		[ 1, 0,-2, 0,-2, 0,-2, 0, 0,11, 0, 0, 0, 2, 1],
		[ 1, 0, 0, 0, 0, 0, 0, 0, 1,10,10,10,10,13, 1],
		[ 1, 1, 1, 1, 1, 1, 1, 1, 1, 1, 1, 1, 1, 1, 1]

		
	
	],
	"extraSpawns": [
		
	]
}
