{
	"data": [
		[ 1, 1, 1, 1, 1, 1, 1, 1, 1, 1, 1],
		[ 2, 0, 0, 0,54, 0, 0, 0, 0, 0, 3],
		[ 1, 0, 0, 1, 1, 1, 1, 1, 1, 1, 1],
		[ 1, 0, 0, 0, 1, 1, 1, 1, 1, 1, 1],
		[ 1, 0,-2, 0, 5,50,50, 0,51,11, 1],
		[ 1, 0, 0, 5, 1,10,41,41,11, 0, 1],
		[ 1, 0, 0, 0, 1,40, 0, 0,42,52, 1],
		[ 1, 0, 0,-2, 1,40, 0, 0,42,52, 1],
		[ 1, 0, 0,-9, 1,13, 0, 0,12,44, 1],
		[ 1, 1, 1, 1, 1, 1, 1, 1, 1, 1, 1]
	],
	"extraSpawns": [
		{"x":5, "y":5, "id":-2}
	]
}

