{
	"data": [
		[ 4, 4, 1, 1, 1, 1, 1, 1, 1, 1, 1, 4, 4],
		[ 4, 4, 1, 0, 0, 0, 0,11, 0, 2, 1, 4, 4],
		[ 1, 1, 1, 0, 1,-2, 1,42, 1,53, 1, 4, 4],
		[ 1,11, 5, 0, 0, 0, 5, 0, 0,43, 1, 4, 4],
		[ 1, 0, 1, 0, 1, 5, 1, 0, 1, 0, 1, 1, 1],
		[ 1,40, 1, 0, 0, 0, 0, 0, 0,52,50, 0, 5],
		[ 1, 1, 1, 0, 1, 0, 1, 0, 1,51, 1, 0, 1],
		[ 1, 0,-4,-9, 0,41, 0, 0, 0, 0, 1, 0, 1],
		[ 1, 1,-4, 1, 1, 1, 1, 1, 1, 1, 1, 3, 1]
		[ 4, 1, 0, 1, 4, 4, 4, 4, 4, 4, 4, 4, 4]
		[ 4, 1, 1, 1, 4, 4, 4, 4, 4, 4, 4, 4, 4]
	],
	"extraSpawns": [
		{"x": 2, "y": 7, "id": -1},
		{"x": 7, "y": 5, "id": -1},
		{"x": 5, "y": 9, "id": -4}
	]
}

