{
	"data": [
		[ 4, 4, 1, 1, 1, 1, 1, 1, 1, 1, 1, 4, 4],
		[ 4, 4, 1, 0, 0, 0, 0, 0, 0, 2, 1, 4, 4],
		[ 1, 1, 1, 0, 1,-2, 1, 0, 1, 1, 1, 4, 4],
		[ 1,11, 5, 0, 0, 0, 0, 0, 0, 0, 1, 4, 4],
		[ 1, 0, 1, 0, 1, 5, 1, 0, 1, 0, 1, 1, 1],
		[ 1,40, 1, 0, 0, 0, 0, 0, 0,-4,50, 0, 5],
		[ 1, 1, 1, 0, 1, 0, 1, 0, 1,51, 1, 0, 1],
		[ 1,-9, 0, 0, 0,41, 0, 0, 0, 0, 1, 0, 1],
		[ 1, 1, 1, 1, 1, 1, 1, 1, 1, 1, 1, 3, 1]
	],
	"extraSpawns": [
		{"x": 7, "y": 5, "id": -1}
	]
}

