{
	"data": [
		[ 4, 4, 4, 4, 4, 4, 4, 4, 4, 4, 4, 4, 4],
		[ 4, 4, 4, 4, 4, 4, 4, 4, 4, 4, 4, 4, 4],
		[ 4, 4, 4, 4, 4, 4, 4, 4, 4, 4, 4, 4, 4],
		[ 4, 4, 4, 4, 4, 4, 4, 4, 4, 4, 4, 4, 4],
		[ 1, 1, 1, 1, 1, 1, 1, 1, 1, 1, 1, 1, 1],
		[-9, 0, 0, 0, 0, 0, 0, 0, 0, 0, 0, 0, 3],
		[ 1, 1, 1, 1, 1, 1, 1, 1, 1, 1, 1, 1, 1],
		[ 4, 4, 4, 4, 4, 4, 4, 4, 4, 4, 4, 4, 4],
		[ 4, 4, 4, 4, 4, 4, 4, 4, 4, 4, 4, 4, 4],
		[ 4, 4, 4, 4, 4, 4, 4, 4, 4, 4, 4, 4, 4],
		[ 4, 4, 4, 4, 4, 4, 4, 4, 4, 4, 4, 4, 4]
	
	],
	"extraSpawns": [
		
	]
}
